####################
#                  #
#            o     #
#                A #
# o                #
#                 o#
# !                #
#   !              #
#                  #
####################

